10 09 03
     XXXXX
XXXXXX.JGX
XG......X 
X.J.XXX.XX
XX....J.GX
 X..XXXXXX
 X.MXXXXXX
 X..X     
 XXXX     