10 09 04
     XXXXX
XXXXXX.JGX
XG.....JXX
X.J.XXXGXX
XX....J.GX
 X..XXXXXX
 X.MXXXXXX
 X..X     
 XXXX     