10 10 04
     XXXXX
     X...X
XXXXXX...X
X..J.....X
X..JXXX.XX
XXGJG.G.GX
 X.JX....X
 X.MXXXXXX
 X..X     
 XXXX     