08 09 02
    XXXX
 XXXX..X
 XG.X..X
 X.....X
 XGXJJ.X
XX...XXX
XM.X.X  
X....X  
XXXXXX  